111111111111111111
100000C00000000C01
100011000111000001
100P000E0000000001
111101101011110111
100000C00000000001
101X10001111000111
100000000000000001
111111111111111111
