111111111111111111
100000C00000000001
100000000000000001
1000000E0000000001
110C0000000000010P
100000000000000001
101110C01111000111
100000000000C00001
111111111111111111
