111111111111111111
1P0000C00000000001
100000111100000001
1000001E1000000001
110C00111000000111
100000000000000001
101110C01111000111
100000000000C00001
111111111111111111
