111111111111111111111111111111111111111111111111111111111111
1P0000C00000000000000000000000000000000000000000000000000001
100000000000000000000000000000000000000000000000000000000001
1000000E0000000000000000000000000000000000000000000000000001
100C00000000000000000000000000000000000000000000000000000001
100000000000000000000000000000000000000000000000000000000001
101111111010000000000000000000000000000000000000000000000001
1000000000000C0000000000000000000000000000000000000000000001
100000000000000000000000000000000000000000000000000000000001
1000000000000CCCCCCCCCCCCCCCCCCCCCCCCC0000000000000000000001
100000000000000000000000000000000000000000000000000000000001
100000000000000000000000000000000000000000000000000000000001
10000000000000000000000000000000CCCCCC0000000000000000000001
100000000000000000000000000000000000000000000000000000000001
100000000000000000000000000000000000000000000000000000000001
100000000000000000000000000000000000000000000000000000000001
100000000000000000000000000000000000000000000000000000000001
100000000000000000000000000000000000000000000000000000000001
100000000000011111111111111111111111110000000000000000000001
100000000000000000000000000000000000000000000000000000000001
100000000000C00000000000000000000000000000000000000000000001
100000000000000000000000000000000000000000000000000000000001
100000000000000000000000000000000000000000000000000000000001
100000000000000000000000000000000000000000000000000000000001
100000000000000000000000000000000000000000000000000000000001
100000000000000000000000000000000000000000000000000000000001
100000000000000000000000000000000000000000000000000000000001
100000000000000000000000000000000000000000000000000000000001
100000000000000000000000000000000000000000000000000000000001
100000000000000000000000000000000000000000000000000000000001
100000000000000000000000000000000000000000000000000000000001
100000000000000000000000000000000000000000000000000000000001
111111111111111111111111111111111111111111111111111111111111