11111111111111111111111111
1P000000000000000000000001
11101111101111011111011111
10001000001000010000010001
10111011101111101111011101
1000001000000000C010000001
11110111101111101111011111
100001000010C0001000000001
10111101111101111101111101
10000C000000010000000000E1
11111111111111111111111111
