1111111111111111111111111111111
1P00000000000100000000000000001
1011111111010111111011111111101
1000000000010000001000000000001
1011111111011111011011111111101
100000000C000010000C00000000001
1011111011111111111111011111101
1000001010000000000001010000001
1011111010111111111101011111101
100000000000000C000000000000001
1111111011111011101111011111101
1C000000000001000010000000000E1
1111111111111111111111111111111
