111111111111111111
100P00C000E0000C01