111111111111111111
1P0000C00000000C01
100011000111000001
100000000000000001
111101111011110111
100000C00000000001
101110001111000111
1000000000000000E1
111111111111111111
