111111
1P0C01
100001
1000E1
111111
