111111111111111111
1P0000C00000000001
100000000000000001
1000000E0000000001
110C00000000000111
100000000000000001
101110001111000111
100000000000100001
111111111111111111
