1111111111111111111111111111111111111111111111111111111111111
1P0000C000000000000000000000000000000000000000000000000000001
1000000000000000000000000000000000000000000000000000000000001
1000000E00000000000000000000000000000000000000000000000000001
100C000000000000000000000000000000000000000000000000000000001
1000000000000000000000000000000000000000000000000000000000001
1011111110100000000000000000000000000000000000000000000000001
1000000000000C00000000000000000000000000000000000000000000001
1000000000000000000000000000000000000000000000000000000000001
1000000000000CCCCCCCCCCCCCCCCCCCCCCCCC00000000000000000000001
1000000000000000000000000000000000000000000000000000000000001
1000000000000000000000000000000000000000000000000000000000001
10000000000000000000000000000000CCCCCC00000000000000000000001
1000000000000000000000000000000000000000000000000000000000001
1000000000000000000000000000000000000000000000000000000000001
1000000000000000000000000000000000000000000000000000000000001
1000000000000000000000000000000000000000000000000000000000001
1000000000000000000000000000000000000000000000000000000000001
1000000000000111111111111111111111111100000000000000000000001
1000000000000000000000000000000000000000000000000000000000001
100000000000C000000000000000000000000000000000000000000000001
1000000000000000000000000000000000000000000000000000000000001
1000000000000000000000000000000000000000000000000000000000001
1000000000000000000000000000000000000000000000000000000000001
1000000000000000000000000000000000000000000000000000000000001
1000000000000000000000000000000000000000000000000000000000001
1000000000000000000000000000000000000000000000000000000000001
1000000000000000000000000000000000000000000000000000000000001
1000000000000000000000000000000000000000000000000000000000001
1000000000000000000000000000000000000000000000000000000000001
1000000000000000000000000000000000000000000000000000000000001
1000000000000000000000000000000000000000000000000000000000001
1111111111111111111111111111111111111111111111111111111111111