111111111111111111
1P0000C00000000001
100000111100000001
1000001C1000000001
110C00111000000111
1000000000000E0001
101110C01111000111
100000000000C00001
111111111111111111
